1111111111111111
1000001110000001
1000000000000001
1000000000000001
1000000000000001
1000000000000001
1000000000000011
1100000000000001
1100000000000011
1000000000000001
1100000000000001
1000000000000001
1000000000000001
1000000000000001
1000000100000001
1000000100000001
1111111111111111
